#######################
#                     #
#                     #
#      ###   ###      #
#                     #
#         ###         #
#                     #
#      ###   ###      #
#                     #
#      #########      #
#      #########      # 
#                     #
#                     #
#######################
