##########################
#                        #
# #     # ##  # #        #
# #     # #   #  #       #
# #  #  # ##  # #        #
# # # # # #   #  #       #
#                        #
#                        #
#     # #                #
#    #                   #
#      #                 #
#    # #                 #
#                        #
##########################
