####################
#                  #
#   ####           #
#                  #
#           ###    #
#                  #
#   ####           #
#                  #
#           ###    #
#                  #
#   ####           #
#                  #
#           ###    #
####################
